@^.^~####^*~~.~^~..~~~^~.^~.*~**.^^*^*^~..*^^..~^.
###~##~^#^~~.*~*.**.~~^*^**.^~*^^.*^...^..^.**.~^*
^^###~.*#*^..^**.~~~.~*.~^^~^~^.^~^*~**.~*^.^**.*.
*~~.~^.~#~^~^^*^**.~.*^^*~~^^*~.^.*^^*^.^.~~^^^*~.
*.^~^^.~##^.^^*~^~~*^..^~^~~^.*^^..**.**~.~~^~*~**
^.^^~^.*~###*~*^*~^*~~^.^.~.~^**~.^^^^*.~.~~~^^.^.
*~~.*.^~~~^#.^*~~~*^.^**^*^.^.^~~***^^*^.~^^.^^.~.
.~.*~~^*.*##~^^~**^.^.^~~~^.~.^~~^^.~^^.^^~.~.~.*^
.^^^~~*~.^#~.*~.~~..~*~^.~**~..^****~.*~^~~*~**^~^
^^^*^^**..##.^^*^^^.*~*~^^~*~~.~****~~~~***.^^~~^~
..*^^^^^.^~#^~.^.^^~*~^*~**^*^.~~~*^.^^~**~*~.....
**.^~~~^~*~#***.**^~.^.*^^^~.^...~.**^^^^~^.~^~.~*
^*~.*.~*^.~#^^^^^*~.**~^.*^*.~~..^~~~*~*^.~~^*^*^^
~*^.^..**~*#^*^~***^~~*^*.*~..~^^***^.*~.^*^^^^.~.
*~^~^**^^###~^*~^^*~~~*^*~~~~*~^^^*~..~~~~~.*~^~*.
^.*.^*^*####~**.*.~^~~~^..~~~*~~^*~..^^.^~*.^~^~**
.***^..*#~~~~^~.*^~~.*.~^.^^*.***^~^.*....~.^.*~^^
^^~~~~.*#.*.^^*.^~~^....*~*^~*^^.^~~~^*.~^^^~**^~~
^~~*^*.~##^^^*^.*..~*...~**^.^^~.^^.^..^.^**.^^..*
~^***~^.~#~^^^*~~~.*..^~^^.~^.~.**...~^~**~^~~**^~
~~~^~.^*.##.~*.*~~^..~*^^~~**.*.*.~^^^..^.~^.*.^~~
^^~...^.*~#^^**~^~*..^~^~*....^.^^**~.*.^^*..~*~.*
^..^...~.~#*.~***~*~~*..~*~^^~~^~**^~~^*^^~*.~*^*^
*^.**^~***#*.~~~..~^~.*.^*~^.^^*^..*~^.^.^*.^.~^^*
~...~*^...####*^^*...^.~~..^.*~.*~.*^.^*^*^.****^~
^..~***^.*^~~###**.~*^.~.^~*.~^*^~^.****~..~*..*^~
.~^~**~^^..~~~^#.*~*.^**~..^^*.~.*..*~~*~.^~.~*~~.
.***~..~**^.~.~#~*.~~**..^.^~..~*~~~~*.**~~^..^.^^
~.*.~^*^*~^.~*.#*~^~~.*.*..*.*..^~.*~^^*.~^.^~^**^
.*^~^^*.^*.~*..#*~~~*.**.~...*.*^.^*.^*~*.^~^**^*.
.~..*....~..~.*##~..~^..~~^*^*^~^^~~**^.*~**^**^^*
^.*.~.^.**^*^.~^#*.~..*^~*^***.~**..^.~~*..^*^~*.~
^~~^~~*.~^^~~^**#^.^^^*^.*^^~~.^.*~^*^^..**..**..^
^.^*.*^..*.~~.^^##*^.*~..~.**^*.~^...^^~*.~^~^..~~
~^^.^..*^^.**.~~^#~*^~*~^~~.~*.^~.~*^~*.*..^.^^*^*
^^.~*^~~*.~~*~.^.#~*.^.~**.^*^.^~.**.~*.~...~~..*.
.~..^.~.~.^*.~^*~#~.*^*~~*.^.******~*~~*^~~~^.~~*~
~.*..^^*^~*.~~.~.#~..~.~^^^.*~*.**~^*~*^*^^~..^~^^
*.^*^**^*.^^*....#*..~^^~.^*^.*~*^**^^######*^^^.~
^*^~^^*.~*~^*~^~~###^*^~*^^~.*~.*~#####~^~~#~*^~~*
~~**~*.^.*~..~~^^^~#^^.~***^*.^*~##~^~*~**.#.~..~.
*~**^~~.^.*.~^**~*^##*^*.^~~*~~~*####.~~^*^#*^.^.*
.*^~..*~.*^^^^^~~^^##~*.~~~.***~^####~~****##~~^*.
.^^..^.^*^~^.~*...*#~~~.**^*~~~*####~^*^~^~~#^^*.*
**.**~.**~.*.*^~~.~##*^.~~*.^*.~####~*^^..~##~*^*^
~..^.****^.****~^~**###^^^^*^.~*####~~.^**^#~^*.~~
^*~^.~*...^^.^~.^^..~^########^#####*~*~*^.#~^*~.~
...^~^.~^^~~~~.*^~.^~***~~^^^#####~###~*~**#***^~^
.~~~~~^^.~~*^.~^^^**~^~.^~^~*####~^#####~^~#######
~^**.~**..*^~^^^.^*^~^~*^.~*~###########~**^~~^~^#
